Date,Type,Amount,Balance
2025-05-01 22:33:31,Deposit,1000,6000.0
2025-05-02 16:51:30,Withdraw,1000,5000.0
2025-05-02 19:00:03,Withdraw,1,4999.0
2025-05-02 19:54:43,Withdraw,1,4998.0
2025-05-02 20:42:18,Deposit,1000,5998.0
2025-05-02 20:42:31,Deposit,1000,6998.0
2025-05-02 20:42:40,Withdraw,1000,5998.0
